--------
---2----
----12--
--------
--2-----
-----1--
--------
-----x--