----------
----------
----------
----123---
---1------
---2------
---3-----x
----------
----------
----------