--------
----1---
------1-
-21-----
-----1--
--x--1--
---3----
--------